......................
......................
......................
.........┌────┐.......
.........│....│.......
.......┌─┘■■■.│.......
.......│..■□□.│.......
.......│.■□□□┌┘.......
.......└──┐..│........
..........└──┘........
......................
......................
......................
