......................
......................
......................
........┌─┐...........
........│□│...........
........│.└──┐........
......┌─┘■.■□│........
......│□.■.┌─┘........
......└──┐■│..........
.........│□│..........
.........└─┘..........
......................
......................
