......................
......................
......................
........┌──┐..........
........│..└──┐.......
........│.■...│.......
.......┌─┐.│..└┐......
.......│□│.└┐..│......
.......│□■..│..│......
.......│□...■..│......
.......└───────┘......
......................
......................
