......................
......................
......┌───┐...........
......│...│...........
......│.■.│.┌─┐.......
......│.■■│.│□│.......
......└─┐.└─┘□│.......
.......┌┘....□│.......
.......│...┬..│.......
.......│...┌──┘.......
.......└───┘..........
......................
......................
