......................
......................
......................
.........┌───┐........
.......┌─┘...│........
.......│..■□.└┐.......
.......│..□■□.│.......
.......└─┐.▣■.│.......
.........│...┌┘.......
.........└───┘........
......................
......................
......................
