......................
.┌──────────────────┐.
.│..................│.
.│..................│.
.│┌─.─┬─.┌─┐.┌─┐.─┬─│.
.│└┐..│..│─│.│┌┘..│.│.
.│─┘..│..│.│.│└┐..│.│.
.│..................│.
.│.........■........│.
.│.........□........│.
.│..................│.
.└──────────────────┘.
......................
