......................
......................
.........┌───┐........
.......┌─┘...│........
.......│□.■..│........
.......┌─┐.■□│........
.......│□┌─■.│........
.......│.╵.□.└┐.......
.......│■.▣■■□│.......
.......│...□..│.......
.......└──────┘.......
......................
......................
