......................
......................
.......┌──┐...........
......┌┘..│...........
......│..■│...........
......└┐■.└┐..........
......┌┘.■.│..........
......│□■..│..........
......│□□▣□│..........
......└────┘..........
......................
......................
......................
