......................
.┌──────────────────┐.
.│..................│.
.│..................│.
.│..................│.
.│.││┌┐││...│││┬┌┐│.│.
.│.└┐││││...│││││││.│.
.│.└┘└┘└┘...└─┘─╵└┘.│.
.│..................│.
.│..................│.
.│..................│.
.└──────────────────┘.
......................
